5 9 6 1 1 1 1 1 1 6 8 4 3 5 9 6 1 1 1 1 
5 9 6 0 0 0 0 0 0 6 8 4 3 5 9 6 0 0 0 0 
5 9 6 6 0 0 0 0 6 6 8 4 3 5 9 6 1 1 1 1 
5 9 6 0 6 0 0 6 0 6 8 4 3 5 9 6 1 1 1 1 
5 9 6 0 0 6 6 0 0 6 8 4 3 5 9 6 1 1 1 1 
5 9 6 0 0 6 6 0 0 6 8 4 3 5 9 6 1 1 1 1 
5 9 6 0 6 0 0 6 0 6 8 4 3 5 9 6 1 1 1 1 
5 9 6 6 0 0 0 0 6 6 8 4 3 5 9 6 1 1 1 1 
5 9 6 0 0 0 0 0 0 6 8 4 3 5 9 6 0 0 0 0 
5 9 6 1 1 1 1 1 1 6 8 4 3 5 9 6 1 1 1 1 
5 9 6 1 1 1 1 1 1 6 8 4 3 5 9 6 1 1 1 1 
5 9 6 1 1 1 1 1 1 6 8 4 3 5 9 6 1 1 1 1 
5 9 6 1 1 1 1 1 1 6 8 4 3 5 9 6 1 1 1 1 
5 9 6 1 1 1 1 1 1 6 8 4 3 5 9 6 1 1 1 1 
5 9 6 1 1 1 1 1 1 6 8 4 3 5 9 6 1 1 1 1 
5 9 6 0 0 0 0 0 0 6 8 4 3 5 9 6 0 0 0 0 
5 9 6 1 1 1 1 1 1 6 8 4 3 5 9 6 1 1 1 1 
5 9 6 1 1 1 1 1 1 6 8 4 3 5 9 6 1 1 1 1 
5 9 6 1 1 1 1 1 1 6 8 4 3 5 9 6 1 1 1 1 
5 9 6 1 1 1 1 1 1 6 8 4 3 5 9 6 1 1 1 1 