3 5 6 1 1 1 1 1 1 6 4 3 7 3 5 6 1 1 1 1 
3 5 6 0 0 0 0 0 0 6 4 3 7 3 5 6 0 0 0 0 
3 5 6 6 0 0 0 0 6 6 4 3 7 3 5 6 1 1 1 1 
3 5 6 0 6 0 0 6 0 6 4 3 7 3 5 6 1 1 1 1 
3 5 6 0 0 6 6 0 0 6 4 3 7 3 5 6 1 1 1 1 
3 5 6 0 0 6 6 0 0 6 4 3 7 3 5 6 1 1 1 1 
3 5 6 0 6 0 0 6 0 6 4 3 7 3 5 6 1 1 1 1 
3 5 6 6 0 0 0 0 6 6 4 3 7 3 5 6 1 1 1 1 
3 5 6 0 0 0 0 0 0 6 4 3 7 3 5 6 0 0 0 0 
3 5 6 1 1 1 1 1 1 6 4 3 7 3 5 6 1 1 1 1 
3 5 6 1 1 1 1 1 1 6 4 3 7 3 5 6 1 1 1 1 
3 5 6 1 1 1 1 1 1 6 4 3 7 3 5 6 1 1 1 1 
3 5 6 1 1 1 1 1 1 6 4 3 7 3 5 6 1 1 1 1 
3 5 6 1 1 1 1 1 1 6 4 3 7 3 5 6 1 1 1 1 
3 5 6 1 1 1 1 1 1 6 4 3 7 3 5 6 1 1 1 1 
3 5 6 0 0 0 0 0 0 6 4 3 7 3 5 6 0 0 0 0 
3 5 6 1 1 1 1 1 1 6 4 3 7 3 5 6 1 1 1 1 
3 5 6 1 1 1 1 1 1 6 4 3 7 3 5 6 1 1 1 1 
3 5 6 1 1 1 1 1 1 6 4 3 7 3 5 6 1 1 1 1 
3 5 6 1 1 1 1 1 1 6 4 3 7 3 5 6 1 1 1 1 